111111111
100000001
1P00000C1
1EE000001
111111111