1111111
1P00001
1000011
1000111
1E11111
1000001
11111C1
1111111